5
10
OOOOOOOOOO
OOSSOSSSSO
OSSOSSOOSO
OMSSSSOKSO
OOOOOOOOOO


